........N.......
.NN...N..N..NNN.
...N.N........N.
..N..NN..N..N...
.NN....N...NN...
.....N....N...N.
.NN...N.N...N...
..NN....N..NNN..
.....N..........

.....N.....N....
.NN..N..N....N..
.........NN...N.
..NN..N..N..NNN.
.N...N.......N..
...NNN..NN.....
.N...N....N...N.
.NN.....N..N..N.
.....N..........

.....N.....N....
.NN..N..N....N..
.....N...NN...N.
..NN..N..N.NNNN.
.N...N.......N..
N..NNN..NN..N..
..........N...N.
.NN..N..N..N..N.
.....N..........

